#############################################
#                                           #
####################     ########### ########
#########                                   #
#           #########   #################   #
##             # #        #               ###
#              # ##########                ##
#   ##########                             ##
####          #####################   #######
#####         #####                   #######
#                                           #
#############################################